  14,   -3,    3,   15,   15,   11,   -3, 
 -13,    0,    5,  -15,    3,    2,    1, 
  12,  -12,   -8,    7,    8,  -11,  -14, 
   7,  -15,   13,   -8,  -14,  -11,   -3, 
  10,  -13,    4,    7,   -7,   13,    1, 
